......B...
~~~~~~~~~~
....a.....
~~~~~~~~~~
..........
.@......b.
....A.....